TTTTTTTTTTTT
.          T
TR         T
T          T
TTTTT X   TT
T    X     T
T   X   X  T
T          T
TTTTTTTTTTTT