TTTTTTTTTTTT
T      RT TT
T RRRT  T  .
T       T TT
T RR R  R  T
T    R     T
T    T     T
TRR  T     T
TTTTTTTTTTTT