TTTTTTTTTTTT
T          T
T  X      RT
T          .
T  X  X   RT
T    X  X  T
T   T      T
T          T
TTTTTTTTTTTT